3333333333333333333
3311311313113111333
3321321213123121333
3311311113113131333
3011111133113131443
3121111111111131443
3331131133333131443
3331231211111111443
3331131333113111133
3333131333113331333
3333333333333333333
