3333333333333333333
3333311133333333333
3333321133333333333
3333311233333333333
3331120213333333333
3331313313333333333
3111313313333311443
3121121111111111443
3333313331313311443
3333311111333333333
3333333333333333333
